10 20
|------------------|
|.F-.....|.....-...|
|.........|.....F..|
|.F....|.....|...-.|
|..-.....@.....|...|
|...|.......|...F..|
|.-....F........|..|
|.F......|......-..|
|...|...-...F..|...|
|------------------|
